CDEFGABCDEFGABCDEFG
......B............
......+............
.....B.............
......B............
....B..............
......+#...........
-------------------
....##B............
......+............
.....B.............
......B............
....B..............
......+............
-------------------
......B............
......+............
.....B.............
......B............
....B..............
......+............
-------------------
....##B............
......+............
.....B.............
......B............
....B..............
......+............
-------------------
......B............
......+............
.....B.............
......B............
....B..............
......+............
-------------------
....##B............
......+............
.....B.............
......B............
....B..............
......+####........
-------------------
........B..........
........+..........
.......B...........
........B..........
......B............
......+............
-------------------
........B..........
........+..........
.......B...........
........B..........
......B............
######+............
-------------------
........B..........
........+..........
.......B...........
........B..........
......B............
......+............
-------------------
........B..........
........+..........
.......B...........
........B..........
......B............
......+############
-------------------
........B..........
........+..........
.......B...........
........B..........
......B............
......+............
-------------------
........B..........
........+..........
.......B...........
........B..........
......B............
......+............
-------------------
###########B......B
...........+......+
...........B......B
...........B......B
..........B......B.
.........B.##...B..
-------------------
........B..........
........+..........
........B..........
........B..........
.......B...........
......B............
-------------------
.......B...........
.......+...........
.......B...........
.......B...........
........B..........
.......B...........
CDEFGABCDEFGABCDEFG
