CDEFGABCDEFGABCDEFG
......B............
......+............
.....B.............
......B............
....B..............
......+............
-------------------
......B............
......+............
.....B.............
......B............
....B..............
......+............
-------------------
......B............
......+............
.....B.............
......B............
....B..............
......+............
-------------------
......B............
......+............
.....B.............
......B............
....B..............
......+............
-------------------
......B............
......+............
.....B.............
......B............
....B..............
......+............
-------------------
......B............
......+............
.....B.............
......B............
....B..............
......+............
-------------------
........B..........
........+..........
.......B...........
........B..........
......B............
......+............
-------------------
........B..........
........+..........
.......B...........
........B..........
......B............
......+............
-------------------
........B..........
........+..........
.......B...........
........B..........
......B............
......+............
-------------------
........B..........
........+..........
.......B...........
........B..........
......B............
......+............
-------------------
........B..........
........+..........
.......B...........
........B..........
......B............
......+............
-------------------
........B..........
........+..........
.......B...........
........B..........
......B............
......+............
-------------------
...........B......B
...........+......+
...........B......B
...........B......B
..........B......B.
.........B......B..
-------------------
........B..........
........+..........
........B..........
........B..........
.......B...........
......B............
-------------------
.......B...........
.......+...........
.......B...........
.......B...........
........B..........
.......B...........
-------------------
BBBBBBBBBBBBBBBBBBB
BBBBBBBBBBBBBBBBBBB
BBBBBBBBBBBBBBBBBBB
BBBBBBBBBBBBBBBBBBB
BBBBBBBBBBBBBBBBBBB
BBBBBBBBBBBBBBBBBBB
BBBBBBBBBBBBBBBBBBB
BBBBBBBBBBBBBBBBBBB
BBBBBBBBBBBBBBBBBBB
BBBBBBBBBBBBBBBBBBB
BBBBBBBBBBBBBBBBBBB
BBBBBBBBBBBBBBBBBBB
BBBBBBBBBBBBBBBBBBB
BBBBBBBBBBBBBBBBBBB
BBBBBBBBBBBBBBBBBBB
BBBBBBBBBBBBBBBBBBB
BBBBBBBBBBBBBBBBBBB
BBBBBBBBBBBBBBBBBBB
CDEFGABCDEFGABCDEFG
